%%%%%%%%%%
%        %
% . .%   %
% .%.% % %
% .%.%.% %
% .%.%.% %
% .%.%.% %
% .%.%.% %
%P.%...% %
%        %
%%%%%%%%%%